@..#############
.......$.......#
#..####..####..#
#.....#.....#..#
#..#..####..####
#..#..#.....#..#
#..####..####..#
#.....#.....#..#
#..#..####..#..#
#..#..#........
#############.&