#############################################################
#.................#.....#..............#..#..#.............@#
#..#######..####..#..#############..####..#..####..#..####..#
#@.#..#.....#..#.....#...........#...........#.....#.....#..#
####..#..####..#######..####..#..#..####..#############..####
#..#........#...........#..#..#..#.....#...........#.....#..#
#..#..####..#..####..#..#..#..####..####..#..##########..#..#
#.....#..#..#..#.....#.....#..#$.#.....#..#..#..............#
####..#..#..####..#######..####..#..#..#######..####..#..####
#........#.....#.....#........#.....#.....#..#..#..#..#.....#
#############..#######..#..#..##########..#..####..#######..#
#.....#..#.....#........#..#.....#.....#...........#........#
####..#..#..####..####..#..#######..#..####..#..#..#..#..#..#
#..#..............#..#..#........#..#........#..#.....#..#..#
#..####..####..####..#######..#..#..####..#..####..####..#..#
#........#..#.$#.....#........#..#.....#..#..#..#..#..#..#.&#
#..#######..####..#..#######..####..#..#..####..#..#..#..####
#..............#..#..#.....#.....#..#..#..#..#.....#........#
####..#..####..#..#..#..#..####..#..####..#..####..#..#..####
#.....#..#.....#..#.....#..#..#..#..#..#..#........#..#.....#
#..#..####..####..####..####..#..#..#..#..#############..#..#
#..#..#.....#..#.....#........#..#.....#........#........#.$#
#..##########..#..####..####..#..#######..#######..####..####
#@.#..#........#..#..#.....#.....#.....#........#.....#..#..#
####..#..####..#..#..#..##########..####..#..#############..#
#.....#.....#.....#.....#....$#.....#.....#.....#.....#..#..#
####..####..#..#######..#..#######..##########..#..#..#..#..#
#...........#.....#...........#..#.................#.....#..#
#######..################..####..#######..#######..#######..#
#....$#........#........#.....#........#.....#..............#
#..#######..#######..#..####..####..#..#..####..#######..####
#..#.....#..#........#.....#........#..#..#.....#...........#
#..#..#..#..#..##########..######################..##########
#.....#..............#$....#...........#..#........#..#..#..#
#..####..#..#..##########..#..##########..#######..#..#..#..#
#.....#..#..#..#.....#..#..#..#........#..#...........#.....#
#######..####..#..####..#..#..####..####..##########..#..#..#
#..#.....#..............#.....#..............#..#..#.....#..#
#..#..#..#############..#######..#..####..#..#..#..####..####
#&....#..............#...........#..#.....#................&#
#############################################################
