###############################################################################
#&.#.....#..#.......................#.$#.......................#..#..........@#
#..####..#..#..##########..#..#..####..####..###################..#..#..#..#..#
#.....#..#..#........#.....#..#.................#.....#..#........#..#..#..#..#
####..#..#..####..#######..####..#######..####..#..####..#######..####..####..#
#...........#..#..#.....#..#.....#..#........#..#.....#..#..............#.....#
#..#######..#..#..#..#############..#..#######..####..#..#######..#######..####
#.....#.....#...........#....$#........#........#..#..#..#.....#.....#........#
#######..#..####..#..####..##########..####..####..#..#..#..#############..####
#.....#..#..#.....#..#..#...........#..#..#..............#..#..#........#.....#
#..#######..####..#..#..#######..#######..#######..#..#..#..#..####..#..#..####
#..#..#..#........#.....#..#........#.....#.....#..#..#........#.....#..#..#.$#
#..#..#..#..####..#..#..#..#..##########..#..#..#..#######..####..####..#..#..#
#...........#..#..#..#..#....................#.....#..#..#...........#.....#..#
#..#..#..####..####..#######..#######..####..#..####..#..####..#..##########..#
#..#..#...........#.....#.....#........#..#..#..#..............#.&#...........#
#..####..#..#..####..##########..####..#..#######..#..#..#..#..####..#######..#
#..#.....#..#..#........#..#........#........#.....#..#..#..#........#.....#..#
#..#..#######..#..####..#..#..####..#..#..#..#######..#..#############..####..#
#..#.....#$....#.....#.....#..#.....#..#..#.....#.....#.....#..#........#.....#
#..#############..#..#######..#######..####..#######..#######..####..####..####
#..#..#..#.....#..#.....#...........#..#..#..#........#........#..#.....#.....#
####..#..#..####..#..#######..##########..##########..####..####..####..#######
#.....#........#..#..#....................#..#...........#...........#..#.....#
#..#######..#############..####..#..####..#..##########..####..#######..####..#
#..#&.............#..#..#.....#..#.....#........#..#...........#..#...........#
#..#############..#..#..#..####..#..####..####..#..#..#..#..####..#..#..#..####
#..#..#..#..#..#..#........#.....#.....#.....#..#.....#..#...........#..#.....#
#..#..#..#..#..#..#..#######..#############..##########..####..#######..#..####
#........#..#..#........#........#$..........#..#........#........#.....#.....#
#######..#..#..#..#..####..#..#######..#..#..#..#..####..#..####..#..#######..#
#........#........#..#..#..#........#..#..#.....#.....#..#.....#..#.....#.....#
#..####..#..##########..#..####..#..#############..#..################..#######
#..#..#.....#..#........#..#..#..#..#.....#.....#..#.....#...........#........#
####..####..#..#..##########..##########..#..#..#..#######..#..####..#..####..#
#..#..............#..#.....#........#.....#..#.....#.....#..#..#...........#..#
#..####..#######..#..#..####..#######..#..#..#######..#..####..####..#######..#
#.....#..#..#........#.................#.....#........#.....#.....#........#..#
####..####..#..#..###################..#######..##########..#..#############..#
#........#.....#...........#.................#..#...........#........#........#
#..#############..##########..####..#..#..#..#..#############..#######..#######
#..#........#..............#.....#..#..#..#...........#.....#..#..#.....#.....#
#..####..####..####..#..####..#######..#######..#..#..#..#######..####..#..#..#
#.....#.....#..#.....#..#$....#.....#..#........#..#..#.....#..............#..#
#..#######..##########..####..#..#..################..#..#..#######..####..#..#
#..#..#........#........#..#.....#..#.....#..............#..#.....#.....#..#..#
#..#..####..##########..#..#############..#..#..####..####..#..#############..#
#..........................#........#.....#..#..#........#..#........#..#.....#
####..#..####..#############..####..####..####..####..#..####..#..#..#..#..#..#
#@....#..#..#........#..#&....#..#.....#..#..#.....#..#..#.....#..#.....#@.#..#
#..#######..#######..#..#######..####..#..#..#..####..#######..#..#..#..####..#
#...........#...........#.......................#.....#........#..#..#........#
###############################################################################
