/------------\/------------\
|............||............|
|./--\./---\.||./---\./--\.|
|#|  |.|   |.||.|   |.|  |#|
|.'--'.'---'.''.'---'.'--'.|
|..........................|
|./--\./\./------\./\./--\.|
|.'--'.||.'--\/--'.||.'--'.|
|......||....||....||......|
'----\.|'--\ || /--'|./----'
*****|.|/--' '' '--\|.|*****
*****|.||**********||.|*****
*****|.|| /--==--\ ||.|*****
-----'.'' |      | ''.'-----
******.   | .... |   .******
-----\./\ |      | /\./-----
*****|.|| '------' ||.|*****
*****|.||          ||.|*****
*****|.|| /------\ ||.|*****
/----'.'' '--\/--' ''.'----\