............
............
.....##.....
....####....
.@.######.&.
############