...........................................]..................................................................
..........................................QWWWE...............................................................
..........................................ZXXXC...............................................................
..............................................................T...............................................
............................................................].G.?.............................................
............................................................QWWWE.............................................
.................................T.........?......QWWWWWE...ASSSD.............................................
..........................]......G........QWWWE...ASSSSSD...ZXXXC..........T...T..............................
.........................QWWE....QWWWE....ZXXXC...ZXXXXXC..................G...G...............?...........]..
................T........ASSD....ASSSD......................].............QWWWWWE...........QWWWE.......QWWWWE
..T.............G...QWE..ASSD....ZXXXC.....................QWE.......QWE..ASSSSSD.....].....ASSSD.......ASSSSD
&@G....]...?..QWWWE.ASD..ASSD...............T..............ZXC.......ASD..ASSSSSD...QWWWE...ASSSD.......ASSSSD
QWWWWWWWWWWWE.ASSSD.ASD..ZXXC......_........G].......................ZXC..ASSSSSD...ASSSD...ASSSD.......ASSSSD
ASSSSSSSSSSSD.ASSSD.ASD..........QWWWE...QWWWWWWE....QWE.......?..........ASSSSSD...ASSSD...ASSSD.......ZXXXXC
ASSSSSSSSSSSD.ASSSD.ASD...]......ASSSD...ASSSSSSD....ASD....QWWWWWWWE.....ASSSSSD...ASSSD...ASSSD...........].
ASSSSSSSSSSSD.ASSSD.ZXC..QWWE....ZXXXC...ASSSSSSD....ASD....ASSSSSSSD.....ASSSSSD...ASSSD...ASSSD.......QWWWWE
ASSSSSSSSSSSD.ASSSD......ASSD............ASSSSSSD....ASD....ASSSSSSSD.....ASSSSSD...ASSSD...ASSSD.......ASSSSD