


................T
......T.........G
&@....G.......QWWWE
QWWWWWWWWWWWE.ASSSD
ASSSSSSSSSSSD.ASSSD
ASSSSSSSSSSSD.ASSSD
ZXXXXXXXXXXXC.ZXXXC
