


................T
......T.........G
&@....G.W.....QWWWE
QWWWWWWWWWWWE.ASSSD
ASSSSSSSSSSSD.ASSSD
ASSSSSSSSSSSD.ASSSD
ZXXXXXXXXXXXC.ZXXXC
