#################################################
#@.......#.....#.............@#..#..#..#..#$....#
#..#..#######..#######..#..####..#..#..#..####..#
#..#.....#..............#...........#..#........#
#######..#..#############..#..#..####..####..####
#$.#..#..#...........#.....#..#..#&.#..#.....#..#
#..#..#..#############..#..#######..#..####..#..#
#..#..#........#........#..............#.....#..#
#..#..#..####..####..#..##########..#######..#..#
#.....#.....#..#.....#...........#..#........#..#
#..####..####..####..#######..#######..#######..#
#..#..#..#..............#........#..#..#........#
#..#..####..#..####..##########..#..#..#..####..#
#..#..#..#..#..#........#...........#.....#.....#
#..#..#..#######..####..#..#######..##########..#
#.................#$....#..#..............#..#..#
#..####..#..#..##########..#..#############..#..#
#..#.....#..#..#.....#.....#.....#........#.....#
####..#..##########..#######..#######..#######..#
#..#..#..#$................#..#...........#.....#
#..#############..#..#..####..####..#..#######..#
#.....#........#..#..#..#...........#..#..#..#..#
#..##########..#######..####..#..#..####..#..#..#
#.....#..#..#.....#&.......#..#..#.....#..#.....#
####..#..#..####..#######..####..#..####..####..#
#.....#.....#..#...........#.....#.....#.....#..#
#..#..#..#..#..#..#..####..#######..#######..#..#
#$.#..#..#..#.....#..#.....#.....#..............#
####..#..################..####..#######..#..####
#.....#.....#..#.....#..#...........#..#..#.....#
####..#..####..#..####..#..####..####..#..####..#
#@............................#...........#....&#
#################################################
