#################################################
#@...$...#.....#..............#..#..#..#..#.....#
#..#..#######..#######..#..####..#..#..#..####..#
#..#.....#..............#...........#..#........#
#######..#..#############..#..#..####..####..####
#..#..#..#...........#.....#..#..#..#..#.....#..#
#..#..#..#############..#..#######..#..####..#..#
#..#..#........#........#..............#.....#..#
#..#..#..####..####..#..##########..#######..#..#
#.....#.....#..#.....#...........#..#........#..#
#..####..####..####..#######..#######..#######..#
#..#..#..#..............#........#..#..#........#
#..#..####..#..####..##########..#..#..#..####..#
#..#..#..#..#..#........#...........#.....#.....#
#..#..#..#######..####..#..#######..##########..#
#.................#.....#..#..............#..#..#
#..####..#..#..##########..#..#############..#..#
#..#.....#..#..#.....#.....#.....#........#.....#
####..#..##########..#######..#######..#######..#
#..#..#..#.................#..#...........#.....#
#..#############..#..#..####..####..#..#######..#
#.....#........#..#..#..#...........#..#..#..#..#
#..##########..#######..####..#..#..####..#..#..#
#.....#..#..#.....#........#..#..#.....#..#.....#
####..#..#..####..#######..####..#..####..####..#
#.....#.....#..#...........#.....#.....#.....#..#
#..#..#..#..#..#..#..####..#######..#######..#..#
#..#..#..#..#.....#..#.....#.....#..............#
####..#..################..####..#######..#..####
#.....#.....#..#.....#..#...........#..#..#.....#
####..#..####..#..####..#..####..####..#..####..#
#.............................#...........#....&#
#################################################
