#################################################
#@..........#...........#..#.....#.....#........#
#..#######..##########..#..####..####..#..#######
#........#.....#........#.....#.................#
#..####..#..#..#######..#..###################..#
#..#..#..#..#....................#.....#........#
####..#..##########..####..####..####..#######..#
#........#...........#........#.....#...........#
#..#..#..#############..#..#############..####..#
#..#..#.....#.....#.....#.................#.....#
#..#############..#..####..#..####..#######..#..#
#........#..............#..#..#..#........#..#..#
#..#######..####..#######..####..####..#..####..#
#..#........#...........#..#..#........#..#..#..#
#..####..##########..#######..#..#..#######..#..#
#..#...........#.....#....$#.....#.....#..#..#..#
#..#..#..#..##########..################..#..#..#
#..#..#..#..#..#..#.................#...........#
#..#######..#..#..#######..#######..####..#..#..#
#..#.....#.....#..#..#.....#.....#.....#..#..#..#
#..####..#..####..#..#..#..#..####..#..##########
#........#...........#..#.....#..#..#..#..#..#..#
##########..#..#..#..####..####..#######..#..#..#
#..#.....#..#..#..#..#........#........#..#.....#
#..#..##########..#..####..#..#..#..####..####..#
#..#........#..#..#..#..#..#.....#..............#
#..#..####..#..#..#..#..#..#..#############..#..#
#.....#..#..#.....#........#...........#.....#..#
#..####..#..####..####..#######..####..#######..#
#..#........#.....#.....#...........#..#........#
##########..#..#######..####..#..#######..####..#
#.................#........#..#..#...........#.&#
#################################################
