/------------\/------------\/------------\/------------\
|............||............||............||............|
|./--\./---\.||./---\./--\.||............||............|
|#|  |.|   |.||.|   |.|  |#||#|  |.|   |.||.|   |.|  |#|
|.'--'.'---'.''.'---'.'--'.||.'--'.'---'.''.'---'.'--'.|
|..........................||..........................|
|./--\./\./------\./\./--\.||./--\./\./------\./\./--\.|
|.'--'.||.'--\/--'.||.'--'.||.'--'.||.'--\/--'.||.'--'.|
|......||....||....||......||......||....||....||......|
'----\.|'--\ || /--'|./----''----\.|'--\ || /--'|./----'
*****|.|/--' '' '--\|.|**********|.|/--' '' '--\|.|*****
*****|.||**********||.|**********|.||**********||.|*****
*****|.|| /--==--\ ||.|**********|.|| /--==--\ ||.|*****
-----'.'' |      | ''.'----------'.'' |      | ''.'-----
******.   | .... |   .************.   | .... |   .******
-----\./\ |      | /\./----------\./\ |      | /\./-----
*****|.|| '------' ||.|**********|.|| '------' ||.|*****
*****|.||          ||.|**********|.||          ||.|*****
*****|.|| /------\ ||.|**********|.|| /------\ ||.|*****
/----'.'' '--\/--' ''.'----\/----'.'' '--\/--' ''.'----\
|............||............||............||............|
|./--\./---\.||./---\./--\.||./--\./---\.||./---\./--\.|
|.'-\|.'---'.''.'---'.|/-'.||.'-\|.'---'.''.'---'.|/-'.|
|#..||.......  .......||..#||#..||.......  .......||..#|
'-\.||./\./------\./\.||./-''-\.||./\./------\./\.||./-'
/-'.''.||.'--\/--'.||.''.'-\/-'.''.||.'--\/--'.||.''.'-\
|......||....||....||......||......||....||....||......|
|./----''--\.||./--''----\.||./----''--\.||./--''----\.|
|.'--------'.''.'--------'.||.'--------'.''.'--------'.|
|..........................||..........................|
'--------------------------''--------------------------'
/------------\/------------\/------------\/------------\
|............||............||............||............|
|./--\./---\.||./---\./--\.||............||............|
|#|  |.|   |.||.|   |.|  |#||#|  |.|   |.||.|   |.|  |#|
|.'--'.'---'.''.'---'.'--'.||.'--'.'---'.''.'---'.'--'.|
|..........................||..........................|
|./--\./\./------\./\./--\.||./--\./\./------\./\./--\.|
|.'--'.||.'--\/--'.||.'--'.||.'--'.||.'--\/--'.||.'--'.|
|......||....||....||......||......||....||....||......|
'----\.|'--\ || /--'|./----''----\.|'--\ || /--'|./----'
*****|.|/--' '' '--\|.|**********|.|/--' '' '--\|.|*****
*****|.||**********||.|**********|.||**********||.|*****
*****|.|| /--==--\ ||.|**********|.|| /--==--\ ||.|*****
-----'.'' |      | ''.'----------'.'' |      | ''.'-----
******.   | .... |   .************.   | .... |   .******
-----\./\ |      | /\./----------\./\ |      | /\./-----
*****|.|| '------' ||.|**********|.|| '------' ||.|*****
*****|.||          ||.|**********|.||          ||.|*****
*****|.|| /------\ ||.|**********|.|| /------\ ||.|*****
/----'.'' '--\/--' ''.'----\/----'.'' '--\/--' ''.'----\
|............||............||............||............|
|./--\./---\.||./---\./--\.||./--\./---\.||./---\./--\.|
|.'-\|.'---'.''.'---'.|/-'.||.'-\|.'---'.''.'---'.|/-'.|
|#..||.......  .......||..#||#..||.......  .......||..#|
'-\.||./\./------\./\.||./-''-\.||./\./------\./\.||./-'
/-'.''.||.'--\/--'.||.''.'-\/-'.''.||.'--\/--'.||.''.'-\
|......||....||....||......||......||....||....||......|
|./----''--\.||./--''----\.||./----''--\.||./--''----\.|
|.'--------'.''.'--------'.||.'--------'.''.'--------'.|
|..........................||..........................|
'--------------------------''--------------------------'